1 0 0 1 0 0 0 0 0 0 0 0 0 1 0 0 0 0 0 0
0 0 0 0 0 0 1 0 0 1 0 1 0 0 0 1 0 0 0 0
0 0 1 0 1 1 0 1 1 0 0 0 0 0 0 0 0 0 0 0
0 0 0 0 0 0 1 0 1 0 1 1 0 0 0 0 0 1 0 0
1 0 0 0 0 1 0 1 0 1 0 1 0 1 1 0 0 0 1 1
0 0 0 1 0 0 0 1 0 0 0 0 0 1 1 0 0 0 0 0
0 1 0 0 0 0 0 1 1 1 0 0 0 1 0 0 0 0 1 0
0 1 1 0 1 0 0 0 0 0 0 1 1 1 0 0 0 1 0 0
0 0 0 0 1 0 1 1 0 0 0 1 0 0 0 0 1 0 0 1
0 1 1 0 1 0 1 0 0 0 0 0 0 0 0 0 0 0 0 0
1 3 6 17
20 10
