0 0 0 1 0 0 1 0 0 1
0 0 0 0 0 0 0 0 0 0
0 0 0 1 0 0 1 0 0 0
0 1 0 0 0 0 0 1 0 0
0 0 0 0 0 0 0 1 0 0
0 0 1 0 0 0 0 0 0 1
0 0 1 0 0 0 0 1 0 0
0 0 0 0 0 0 0 1 0 0
0 0 0 0 0 0 0 0 0 0
1 0 0 0 0 0 0 0 0 0
8 1 6 8
10 10
