1 0 0 0 0 0 0 0 0 0
0 0 0 0 0 0 1 0 0 0
0 0 0 1 0 0 0 0 1 0
1 0 0 0 0 0 0 0 0 0
0 1 0 0 0 0 0 0 0 0
0 0 0 0 1 0 1 0 0 0
0 1 0 0 1 0 1 0 0 1
0 0 0 0 0 0 0 0 0 0
0 0 0 1 0 1 0 1 0 0
0 0 0 0 0 0 0 0 0 0
7 1 9 8
10 10
