0 0 0 0 0 0 0 0 0 0
1 1 0 0 0 0 0 0 0 0
0 0 0 1 0 0 0 0 0 0
0 0 0 0 0 0 0 0 0 0
0 0 0 1 1 0 0 0 1 0
0 0 0 1 0 0 0 0 0 0
1 1 0 0 0 0 0 0 0 0
0 0 0 0 1 0 1 0 1 0
0 1 0 0 0 0 0 0 0 0
0 0 0 0 0 0 0 0 1 0
7 1 5 8
10 10
