1 0 1 1 0 0 1 0 0 0
0 0 0 1 1 1 0 0 0 0
0 0 0 1 1 0 0 0 0 0
0 0 1 1 1 0 0 0 1 0
1 0 1 1 0 1 0 0 0 0
0 0 0 0 0 0 0 0 0 0
0 0 1 1 0 0 0 0 0 0
0 0 1 0 1 1 1 1 0 0
1 1 0 1 0 0 1 1 0 0
0 0 0 0 0 1 1 1 0 0
3 1 6 8
10 10
