0 0 0 0 0 0 0 0 0 0
0 0 0 0 0 0 0 0 1 1
0 0 0 0 0 1 0 0 0 0
0 0 0 0 0 0 1 0 0 0
0 0 0 0 0 0 0 0 0 0
0 0 1 0 1 0 1 0 1 0
0 0 0 0 0 0 1 1 1 1
0 0 0 0 0 0 1 1 0 0
1 0 0 1 0 0 0 0 0 0
1 1 0 1 1 0 0 0 1 0
2 1 4 8
10 10
