0 1 0 0 0 0 0 0 0 1
0 0 1 0 0 1 0 0 0 0
0 1 0 0 0 0 0 1 0 0
0 1 0 0 1 0 0 0 0 0
0 0 0 0 0 0 0 0 1 0
1 1 0 0 0 1 0 0 0 0
0 1 0 0 0 0 0 0 0 0
0 1 0 0 1 0 0 0 0 0
0 1 0 0 0 0 0 0 0 0
0 1 0 0 0 0 0 0 0 0
1 1 9 8
10 10
